'odia',  'assamese',  'thai',  'gujrati',  'russian',  'japanese',  'punjabi',  'hindi',  'manipuri',  'korean',  'bhojpuri',  'sanskrit',  'english',  'french',  'bodo',  'malayalam',  'telugu',  'kannada',  'dogri',  'marathi',  'german',  'italian',  'rajasthani',  'spanish',  'arabic',  'urdu',  'gujarati',  'tamil',  'bengali', 

final_characters_ = '''	 !"#$%&'()*+,-./0123456789:;<=>?@[\]^_`abcdefghijklmnopqrstuvwxyz{}~ ¡«­°´µ·º»½ßàáâãäåæçèéêëìíîïðñòóôöøùúûüþÿāąćčđėęěğīıľłńňōőœřśşšūŭźżžșțəʻʼʾʿː˜̨́μабвгдежзийклмнопрстуфхцчшщъыьэюяѐёљҙҡңүҳדהו،ؑؓؔ؛؟ءآأؤإئابةتثجحخدذرزسشصضطظعغـفقكلمنهوىيًٌٍَُِّْٓٔٗ٬ٰٴٹپچڈڑژکگںھہۂۃیےۓ۔ۖۗۘۙۚۛँंःअआइईउऊऋऌऍऎएऐऑऒओऔकखगघङचछजझञटठडढणतथदधनऩपफबभमयरऱलळऴवशषसहऺऻ़ऽािीुूृॄॅॆेैॉॊोौ्ॏॐ॒॑॓॔ॕॖॗक़ख़ग़ज़ड़ढ़फ़य़ॠॡॢ।॥०१२३४५६७८९॰ॲॽঁংঃঅআইঈউঊঋএঐওঔকখগঘঙচছজঝঞটঠডঢণতথদধনপফবভমযরলশষসহ়ঽািীুূৃৄেৈোৌ্ৎৗড়ঢ়য়০১২৩৪৫৬৭৮৯ৰৱ৵৷৹৻ਁਂਅਆਇਈਉਊਏਐਓਔਕਖਗਘਙਚਛਜਝਞਟਠਡਢਣਤਥਦਧਨਪਫਬਭਮਯਰਲਵਸ਼ਸਹ਼ਾਿੀੁੂੇੈੋੌ੍ਖ਼ਗ਼ਜ਼ੜਫ਼ੰੱੲੳઁંઃઅઆઇઈઉઊઋઍએઐઑઓઔકખગઘઙચછજઝઞટઠડઢણતથદધનપફબભમયરલળવશષસહ઼ાિીુૂૃૄૅેૈૉોૌ્ૐૠૢ૦૧૨૩૪૫૬૭૮૯ଁଂଃଅଆଇଈଉଊଋଏଐଓଔକଖଗଘଙଚଛଜଝଞଟଠଡଢଣତଥଦଧନପଫବଭମଯରଲଳଵଶଷସହ଼ଽାିୀୁୂୃୄେୈୋୌ୍ୖ୘ଡ଼ଢ଼ୟୠୢ୦୧୨୩୪୫୬୭୮୯୰ୱஃஅஆஇஈஉஊஎஏஐஒஓஔகஙசஜஞடணதநனபமயரறலளழவஷஸஹாிீுூெேைொோௌ்ௗఁంఃఅఆఇఈఉఊఋఎఏఐఒఓఔకఖగఘఙచఛజఝఞటఠడఢణతథదధనపఫబభమయరఱలళవశషసహాిీుూృెేైొోౌ్ౖಂಃಅಆಇಈಉಊಋಎಏಐಒಓಔಕಖಗಘಙಚಛಜಝಞಟಠಡಢಣತಥದಧನಪಫಬಭಮಯರಱಲಳವಶಷಸಹ಼ಽಾಿೀುೂೃೆೇೈೊೋೌ್ೕೖೞೠ೦೧೨೩೪೫೬೭೮೯ംഃഅആഇഈഉഊഋഎഏഐഒഓഔകഖഗഘങചഛജഝഞടഠഡഢണതഥദധനപഫബഭമയരറലളഴവശഷസഹാിീുൂൃെേൈൊോൌ്ൗൺൻർൽൾกขคฆงจฉชซญณดตถทธนบปผฝพฟภมยรฤลวศษสหอฮะัาำิีึืุูเแโใไ็่้๊๋์ḥṇṛṣṭễ  ​‌‍‎‑–—―‘’“”„•…′›€₹™−☆♡♭♯⤴、。々〇〈〉「」『』〜ぁあぃいぅうぇえぉおかがきぎくぐけげこごさざしじすずせぜそぞただちっつづてでとどなにぬねのはばぱひびぴふぶぷへべぺほぼぽまみむめもゃやゅゆょよらりるれろゎわゐをん゛ゝゞァアィイゥウェエォオカガキギクグケゲコゴサザシジスズセゼソゾタダチッツテデトドナニヌネノハバパヒビピフブプヘベペホボポマミムメモャヤュユョヨラリルレロワンヴヵヶ・ー一丁七万丈三上下不与且世丘両並中丰串丸丹主丼乃久之乏乖乗乙九也乱乳乾亀了予争事二于云互五井亘亜亡交京亭人仁今介仏仕他付仙代令以仮仰仲件任企伊伍伏伐休会伝传伯伴伸似但佇位低住佐体何余作佳併使例侑供依価侮侵便係俄俗保俟信俣修俯俳俺倉個倍倒候借倣値倫倶偉偏做停健側偵偶偽傍傑傘備催債傷傾僅働像僕僚僧儀億儘儚償優允元兄充兆先光克免兎児党入全八公六共兵具典兼内円冊再冒冗写冠冬冴冷凄凌凍凛凝凡処凧凪凶出函刀刃分切刈刊刑列初判別利到制刷券刺刻則削前剛剣剤剥副割創劇力功加劣助努劫励労効勃勇勉動勘務勝募勢勤勧勿匂包化北匠匹区医匿十千午半卑卒卓協南単博占印危即却卵厄厚原厨厭厳去参及友双反収取受叙叛叡口古句叩只叫召可台叱史右叶号司各合吉吊同名后吐向君吟吠否含吸吹吾呂呆呈呉告呑呟周味呻呼命咋和咥咲咳咽哀品員哲唄唆唇唐唖唯唱唸唾商問善喉喋喚喜喧喩喪喫喬喰営嗅嘆嘉嘘嘩嘲噂噌噛器噴囚四回因団困囲図固国圏園土圧在地坂均坊坐坑坪垂型垢垣埃埋城域執培基埼堀堂堅堕堤堪報場堵堺塀塁塊塔塗塙塚塩塵塾境墓増墨壁壇壊壌士壬壮声壱売壷壺変夏夕外多夜夢大天太夫央失奄奇奈奉奏契奔套奥奨奪奮女奴好如妃妄妖妙妥妨妬妹妻姉始姓委姦姫姶姻姿威娘娯婆婚婦婿媒媛媽嫁嫉嫌嬉嬢嬬子孔孕字存孝季孤学孫宅宇守安完宍宗官宙定宛宜宝実客宣室宮宰害宴宵家容宿寂寄密富寒寛寝察寧審寵寸寺対寿封専射将尊尋導小少尖尚尤就尺尻尼尽尾尿局居屈届屋屏屑展属層履屯山岐岡岩岬岸峙峠峡峰島崇崎崔崖崩嵐嵩嶋川州巡巣工左巧巨差己巻巾市布帆希帖帝師席帯帰帳常帽幅幌幕幡干平年并幸幹幻幼幽幾庁広庄床序底庖店府度座庫庭庵康廃廉廊廓延廷建廻廿弁弄弊式弐弓引弘弟弥弦弱張強弾当彙形彦彩彫彰影役彼往征待律後徐徒従得御復循微徳徴徹徽心必忍志忘忙応忠快念怒怖思怠急性怨怪怯恋恐恥恨恩息恰恵悔悟悠患悦悩悪悲悶情惑惚惜惟惨惰想惹愉意愕愚愛感慄慈態慌慎慕慢慣慨慮慰慶憂憎憐憑憚憤憧憩憲憶應懊懐懸成我戒或戚戦戯戸戻房所扇扉手才打払扱扶批承技抄把抑投抗折抜択披抱抵抹押抽担拉拍拒拓拗拘招拝拠拡括拭拳拶拾持指挑挙挟挨挫振挾挿捉捌捕捜捧捨捲捻掃授掌排掘掛掟掠採探接控推措掬掲掴掻揃揄描提揖揚換握揮援揶揺損搬搭携搾摂摘摩撃撒撚撞撤撫播撮擁操擢擦支改攻放政故敏救敗教敢散敦敬数整敵敷文斉斎斐斑斗料斜斧斬断斯新方於施旅族旗既日旦旧旨早旬旭旺昂昆昇昌明易昔星映春昧昨昭是昼時晒晦晩普景晴晶智暇暑暖暗暦暫暮暴曇曖曜曲曳更書曹曽替最月有朋服朕朗望朝期朦朧木未末本札朴机权杉李材村杓杖杜束条来杭杯東杵松板析枕林枚果枝枢枯架柄柏染柔柢柱柳柴柵査柿栃栄栖栗校株核根格栽桁桂桃案桎桐桑桔桜桶梁梅梏梗條梧梨梯械梱梼棄棋棒棚棟森棲椅植椎検楊楢業極楽概榛構槌様槻槽標模権横樹樽橄橋橙機橿檎檜櫃櫻欄欅欒欖欠次欧欲欺歌歎歓止正此武歩歪歯歳歴死歿殊残殖殴段殺殻殿母毎毒比毛毫毯氏民気水氷永汁求汗汚汝江池汲決汽沈沖沙没沢沫河沸油治沼沿況泉泊法泡波泣泥注泪泰泳洋洒洗洞津洪洲活派流浄浅浙浜浦浩浪浮浴海浸消涌涎涙涯液涼淀淡深淵混淹添清渇済渉渋渓減渡渦温測港渾湖湧湯湾湿満源準溜溝溢溶溺滅滋滑滝滞滲滴漁漂漆漏演漕漠漢漫漬潔潜潟潤潮潰澄澤激濁濃濡濫濯瀋瀞瀟瀬灘火灯灰災炉炊炎炒炬炭炸点為烈烏烹焔無焦然焼煉煎煙照煮熊熟熱熾燃燈燕燥燵爆爪爵父爺爽爾片版牙牛牝牟牡牢牧物牲特牽犠犧犬犯状狂狐狙狛狩独狭猛猟猪猫献猶猿獄獅獣獰獲玄率玉王玖珀珂珍珠班現球理琢琥琴瑕瑛瑞璃璧環瓢瓦瓶甘生産甥用田由甲申男町画界畏畑留畜畠畢略番異畳畷疆疑疫疲疵疾病症痛痩痰痴痺瘠療癒癖癪発登發白百的皆皇皮皺皿盆益盗盛盟監盤目盲直相盾省眉看県真眠眸眺眼着睡督睦瞑瞬瞭瞳矛矢知矩短矮矯石砂研砕砥砦砲破砺硝硬确碁碑碗碧確磁磐磨磯礎礫示礼社祈祉祓祖祝神祠祢祥票祭禁禄禅禍福禽秀私秋科秒秘秦秩称移程税稚種稲稼稽稿穀穂積穏穴究空突窃窓窟窪竈立竜竟章童端競竹笑笛笠符第笹筆筈等筋筑筒答策箆箇箋箔箕算管箱箸節範築篠簔簡簾簿籍籐籠米粉粋粒粕粗粘粛粟粧精糖糞糠糧糸系紀約紅紋納紐純紗紙級紛素索紫細紳紹終組絆経結絞絡給絨統絵絶絹継続綜維綱網綺綻綾綿緊総緑緒線締編緩練縁縄縛縞縦縫縮績繁繊繋織繕繞繫繰繹纂纏缶罠罪置罰署罵羅羊美群義羽翁翅翌習翔翻翼老考者耆而耐耕耳聖聞聴職肆肉肌肘肝股肢肥肩肪肯育肺胃胆背胎胞胡胸能脂脅脆脇脈脊脚脱脳脹腎腐腑腕腰腱腹腿膚膜膝膨膳膵臆臍臓臣臨自臭至致臼興舌舎舐舗舘舞舟航般船艘艦良色艶芋芝芥芦芯花芳芸芽苅苑苓苔苗苛若苦苫英苺茂茅茎茨茶茹草荒荘荷菅菊菓菜華菰菱萌萎萩落葉著葛葦葬葵蒙蒡蒲蒸蓄蓋蓬蓮蔑蔓蔭蔵蕎蕨薄薇薔薩薬藁藍藝藤藻蘂蘆蘇蘭虎虚虫虹虻蚊蛇蛍蛙蛮蛹蛾蝉蝶融蟲蟹蟻蠣血衆行術街衛衝衡衣表衰衾袋袖被袴裁裂装裏裕補裳裸製裾複褐褪襟襲西要覆覇見規視覗覚覧親観角解触言訂計訊討訓託記訟訣訪設許訳訴診証詐詑評詞詠詣試詩詮詰話詳誇誉誌認誑誓誕誘語誠誤誦説読誰課調談請諏論諦諫諸謀謂謎謙講謝謡謬謹識譜警議譲護讐认话读谷豆豊豚象豪貌貝貞負財貢貧貨販貪貫責貯貰貴買貸費貼貿賀賂賃賄資賊賑賛賞賠賢賦質賭購賽贅贈赤赦走起超越趣足距跡跨路跳践踊踏蹟蹴躇躊躍身車軋軌軍軒軟転軸軽較載輝輩輪輸輾轄辛辞辰辱農辺込辿迅迎近返这迦迫述迷追退送逃逅逆透逐途逗這通逝速造逢連逮週進逸遂遅遇遊運遍過道達違遠遣遥適遭遮遷選遺遼遽避邂還邑那邦邪邸郊郎郡部郵郷都鄙鄭配酒酔酢酬酵酷酸醍醐醒醜醤釈里重野量金釘釜針釣釧鈍鈴鉄鉛鉢鉱鉾銀銃銅銚銭鋤鋭錆錠錦録鍋鍛鍵鎌鎖鏡鐘鑑長門閃閉開閑間関閣閨閲闇闘阅阜阪防阻阿陀附降限陛陝院陣除陥陰陳陵陸険陽隅隆隊隋階随隔隙際障隠隣隷隻雀雄雅集雇雑離難雨雪雫雰雲雷電需震霊霞霧露霹靂青静非面革靴鞍鞘鞠鞭韋韓韮音韻響頂頃項順須預頑頓頗領頬頭頷頸頻頼題額顎顔顕願類顧领風飛飜食飢飯飲飴飼飽飾餃餅養餌餓館饅首香馬馭馳馴駄駅駆駈駐駒駝駿騎騒験騨騰驚骨骸高髪髭鬱鬼魂魅魔魚鮫鮭鮮鯖鯛鰐鰡鰭鰺鰻鳥鳩鳴鴉鴎鴨鴻鶏鶴鷲鷹鸞鹸鹿麗麦麺麻黄黒黙鼓鼠鼻鼾齢齧龍ꞌ가각간갈감갑값갓갔강갖같갚개객갠갤갯갱거걱건걷걸검겁것겉게겐겟겠겨격겪견결겸겹겼경곁계고곡곤곧골곰곱곳공곶과곽관괄괌광괘괭괴굉교구국군굳굴굵굶굽굿궁궈권궐궤귀규균그극근글금급긋긍기긴길김깁깃깊까깎깔깝깡깥깨깬꺼껍껏껑께껴꼈꼬꼭꼴꼼꼽꽁꽂꽃꽝꽥꾸꾼꿀꿇꿈꿎꿔꿨꿰뀌뀐끄끅끈끊끌끓끔끗끝끼끽낀낌나낙난날낡남납낫났낭낮낯낳내낸낼냄냅냇냈냉냐냥너넉넌널넓넘넛넣네넥넨넷녀녁년념녔녕녘노녹논놀놈농높놓놨뇌뇨뇽누눈눌눠뉜뉴늉느는늘늠능늦늪늬니닉닌닐님닙닛닝다닥닦단닫달닭닮닳담답닷당닿대댁댐댓더덕던덜덟덤덧덩덫덮데덴델뎅뎌도독돈돋돌돔돕돗동돛돼됐되된될됨됩두둑둔둘둠둥둬뒀뒤뒷듀드득든듣들듬듭듯등디딘딜딥딨딩딪따딱딴딸땀땄땅때땐땠땡떠떡떤떨떴떻떼뗄또똑똥뚜뚝뚫뛰뛴뜨뜯뜸뜻띄띔띠띤띨띵라락란랄람랍랐랑래랙랜램랫랬랭랴략량러럭런럴럼럽렀렁렇레렉렌렘렛려력련렬렴렵렷렸령례로록론롤롬롭롯롱뢰료룡루룬룰룸룹뤄뤘뤼류륙륜률륭르륵른를름릅릇릉릎리릭린릴림립릿링마막만많맏말맑맘맙맛망맞맡매맥맨맹맺머먹먼멀멈멋멍메멕멘멜멧며면멸명몇모목몫몬몰몸못몽묘무묵묶문묻물뭄뭇뭐뭔뭘뮤뮬므믈미믹민믿밀밋밌밍및밑바박밖반받발밝밤밥방밭배백밴뱀뱃뱅버벅번벌범법벗벚베벤벨벳벼벽변별볍볐병볕보복볶본볼봄봅봇봉봐봤뵈뵙부북분불붉붐붓붕붙뷔뷰브븐블비빅빈빌빗빙빚빛빠빨빵빼뺀뺌뺏뺑뻐뻑뻔뻗뻘뼈뽀뽑뽕뿌뿐뿜쁘쁜쁩삐사삭산살삶삼삽삿샀상새색샌샐샘생샤샬샵샷서석섞선섣설섬섭섯섰성세섹센셀셈셉셋셔션셜셨셰소속손솔솜솟송솥쇄쇠쇤쇼숍수숙순술숨숭숲쉬쉰쉼쉽슈슐스슨슬슴습슷승시식신실싫심십싱싶싸싹싼쌀쌈쌌쌍쌓써썩썰썼쏘쏜쏟쏠쑤쓰쓴쓸씀씁씌씨씩씬씸씻아악안앉않알앓암압앗았앙앞애액앤앨앱앵야약얇양얗얘어억언얹얻얼얽엄업없엇었엉엎에엑엔엘엠엡엣여역연열엷염엽엿였영옆예옛오옥온올옮옳옴옵옷옹와완왈왔왕왜외왼요욕용우욱운울움웁웃웅워원월웠웨웬웹위윈윌윗윙유육윤율융으은을음읍응의이익인일읽잃임입잇있잉잊잎자작잔잖잘잠잡잣장잦재잭잰잽쟁저적전절젊젋점접젓정젖제젝젠젤져젼졌조족존졸좀좁종좋좌죄죠주죽준줄줍중줘줬쥐쥔쥘쥬즈즉즌즐즘증지직진질짊짐집짓징짖짙짚짜짝짧짬째쨌쩌쩍쩔쩜쪼쪽쫄쫓쭉쯤찌찍찔찢찧차착찬찮찰참찻창찾채책챌챔챙챠처척천철첨첩첫청체첸첼쳇쳐쳤초촉촌촘촛총촨촬최추축춘출춤충춰취츠측츰층치칙친칠침칩칫칭카칸칼캉캐캔캘캠커컥컨컫컴컵컷컸케켈켐켑켓켜켰코콘콜콤콥콧콩쾌쿄쿠쿡쿨쿼퀴큐크큰클큼키킥킨킬킷킹타탁탄탈탐탑탓탕태택탠탬탱터턱턴털텃텅테텍텐텔템텼토톡톤톨톰통퇴투툴툼퉁튀튜튬트특튼튿틀틈티틱틴틸팀팅파팍팎판팔팜팡패팩팬팰팻팽퍼펀펄펌페펜펠펫펴편펼폄폈평폐포폭폰폴폼표푸푹푼풀품풋풍퓨퓰프픈플픔피픽핀필핏핑하학한할함합핫항해핵핸햇했행향허헌헐험헝헤헨헬헴헷혀혁현혈혐협혔형혜호혹혼홀홈홉홍화확환활황회획횡효후훈훌훤훨훼휘휩휴흉흐흑흔흘흙흠흡흥흩희흰히힌힐힘ﭨﮭﮯﯾﷲﷺ︎️ﺃﺅﺗﺘﺩﺲﻧﻮ﻿！（），．／；＝？＼＾ａｂｃｄｆｇｈｉｊｋｌｍｎｏｐｒｓｔｕｖｗｙｚ～｢｣ｩ'''

english =''' !"#$%&'()*+,-.0123456789:;<=>?@[\]^_`abcdefghijklmnopqrstuvwxyz{} ­´»àáâæçèéêíïñôúüœ˜ҙҡүҳ​‌–—‘’“”•…€™️'''

hindi =''' !"'(),-.0123456789;?abcdefghijklmnopqrstuvwxyzँंःअआइईउऊऋऌऍऎएऐऑओऔकखगघङचछजझञटठडढणतथदधनपफबभमयरलळवशषसहऻ़ािीुूृॄॅॆेैॉॊोौ्ॏॐ॒॓॔ॕॖॗक़ख़ग़ज़ड़ढ़फ़ॠॡॢ।॥०॰'''

kannada ='''	 !"#$%&'()*+,-./0123456789:;<=>?[]^`abcdefghiklmnopqrstuvwxy ½ʼॐ।॥ಂಃಅಆಇಈಉಊಋಎಏಐಒಓಔಕಖಗಘಙಚಛಜಝಞಟಠಡಢಣತಥದಧನಪಫಬಭಮಯರಱಲಳವಶಷಸಹ಼ಽಾಿೀುೂೃೆೇೈೊೋೌ್ೕೖೞೠ೦೧೨೩೪೫೬೭೮೯ ​‌‍–‘’“”•…'''

tamil =''' !"%&'()*,-./0123456789:;?[]`abcdefghijklmnopqrstuvwxyz ­ஃஅஆஇஈஉஊஎஏஐஒஓஔகஙசஜஞடணதநனபமயரறலளழவஷஸஹாிீுூெேைொோௌ்ௗ‌–‘’“”…'''

assamese =''' !%&'()+,-./0123456789:;?[]_abcdefghijklmnopqrstuvwxyz ʼ।॥ঁংঃঅআইঈউঊঋএঐওঔকখগঘঙচছজঝঞটঠডঢণতথদধনপফবভমযরলশষসহ়ািীুূৃেৈোৌ্ৎড়ঢ়য়০১২৩৪৫৬৭৮৯ৰৱ৷৹​‌‍–—‘’“”'''

dogri =''' !$%&'()+,-./0123456789:;?@[]`abcdefghijklmnopqrstuvwxyzʼँंःअआइईउऊएऐऑओऔकखगघङचछजझञटठडढणतथदधनपफबभमयरऱलवशषसह़ऽािीुूृेैॉोौ्क़ज़ड़ढ़फ़य़।​‌‍–—‘’“”…′₹'''

bodo =''' !$%&'()+,-./0123456789:;?[]_abcdefghijklmnopqrstuvwxyz °º½ʼँंःअआइईउऊऋऎएऐऑओऔकखगघङचछजझञटठडढणतथदधनऩपफबभमयरऱलवशषसह़ािीुूृॅॆेैॉॊोौ्ज़ड़फ़य़।०ॽ​‌‍–‘’“”'''

marathi =''' !'*+,-./0123456789:;?[`z ँंःअआइईउऊऋऌऍऎएऐऑऒओऔकखगघङचछजझञटठडढणतथदधनऩपफबभमयरऱलळऴवशषसह़ऽािीुूृॄॅॆेैॉॊोौ्ॐ॑ॕक़ज़ड़ढ़फ़य़ॠॡ।॥०१२३४५६७८९ॲ‌‍–‘’“”›'''

bengali =''' !',-.0123456789;?acdefghlmnrstuyz।ঁংঃঅআইঈউঊঋএঐওঔকখগঘঙচছজঝঞটঠডঢণতথদধনপফবভমযরলশষসহ়ঽািীুূৃৄেৈোৌ্ৎৗড়ঢ়য়০১২৩৪৫৬৭৮৯ৰৱ৵৷৻‌‍—‘’'''

telugu =''' !"'*,-./258:;?o ।ఁంఃఅఆఇఈఉఊఋఎఏఐఒఓఔకఖగఘఙచఛజఝఞటఠడఢణతథదధనపఫబభమయరఱలళవశషసహాిీుూృెేైొోౌ్ౖ​‌–‘’”…﻿'''

german =''' '-abcdefghijklmnopqrstuvwxyzßàäèéöü'''

spanish =''' !'-.;?abcdefghijklmnopqrstuvwxyzáéíñóúü'''

french =''' !'-.;?abcdefghijklmnopqrstuvwxyzàâæçèéêëîïôùûüÿœ'''

punjabi =''' !"'(),-.:?bden।ਁਂਅਆਇਈਉਊਏਐਓਔਕਖਗਘਙਚਛਜਝਞਟਠਡਢਣਤਥਦਧਨਪਫਬਭਮਯਰਲਵਸ਼ਸਹ਼ਾਿੀੁੂੇੈੋੌ੍ਖ਼ਗ਼ਜ਼ੜਫ਼ੰੱੲੳ –‘’“”…'''

sanskrit =''' "ँंःअआइईउऊऋऌऎएऐऑओऔकखगघङचछजझञटठडढणतथदधनपफबभमयरलळवशषसह़ऽािीुूृॄॅॆेैॉॊोौ्ॐ॒॑ॠॡॢ।॥०१२३४५६७८९॰'''

odia =''' "',-.;।ଁଂଃଅଆଇଈଉଊଋଏଐଓଔକଖଗଘଙଚଛଜଝଞଟଠଡଢଣତଥଦଧନପଫବଭମଯରଲଳଵଶଷସହ଼ଽାିୀୁୂୃୄେୈୋୌ୍ୖ୘ଡ଼ଢ଼ୟୠୢ୦୧୨୩୪୫୬୭୮୯୰ୱ‌‘’”'''

urdu =''' !"',-.:`abcdeghiklrtuy،ؑؓؔ؛؟ءآأؤئابتثجحخدذرزسشصضطظعغفقكلمنهوىيًَُِّْٓٔٗ٬ٰٴٹپچڈڑژکگںھہۂۃیےۓ۔।‘’“”…ﭨﮭﮯﯾﷲﷺﺅﺗﺘﺩﺲﻧﻮ'''

gujarati =''' !',-.:;?m ।ઁંઃઅઆઇઈઉઊઋઍએઐઑઓઔકખગઘઙચછજઝઞટઠડઢણતથદધનપફબભમયરલળવશષસહ઼ાિીુૂૃૄૅેૈૉોૌ્ૐૠૢ૦૧૨૩૪૫૬૭૮૯‌–‘’…﻿'''

rajasthani =''' !'(),-.0123456789:;?xँंःअआइईउऊऋऍएऐऑओऔकखगघचछजझञटठडढणतथदधनपफबभमयरलळवशषसह़ािीुूृेैॉोौ्क़ख़ग़ज़ड़ढ़फ़ॠ।०१२३७८९​‍‘’…'''

malayalam =''' !,?ംഃഅആഇഈഉഊഋഎഏഐഒഓഔകഖഗഘങചഛജഝഞടഠഡഢണതഥദധനപഫബഭമയരറലളഴവശഷസഹാിീുൂൃെേൈൊോൌ്ൗൺൻർൽൾ'''

manipuri =''' ,-.mnঁংঅআইঈউঊএঐওঔকখগঘঙচছজঝঞটঠডণতথদধনপফবভমযরলশষসহ়ািীুূৃেৈোৌ্ৎয়০১২৩৪৫৬৭৮৯ৰৱ৷'''

gujrati =''' !"'(),-.0123456789:?{} ­âઁંઃઅઆઇઈઉઊઋઍએઐઑઓઔકખગઘચછજઝઞટઠડઢણતથદધનપફબભમયરલળવશષસહ઼ાિીુૂૃૅેૈૉોૌ્ૠ૦૧૨૩૪૫૬૭૮૯​‌‍–—‘’“”…'''

bhojpuri ='''	 !"'(),-.012346789:?`abeimpy{}·ँंःअआइईउऊऋऍऎएऐऑऒओऔकखगघङचछजझञटठडढणतथदधनपफबभमयरऱलळवशषसहऺ़ऽािीुूृॅॆेैॉॊोौ्ॐॕॖक़ख़ग़ज़ड़ढ़फ़य़ॠ।०२६९॰ ​‌‍‎‘’'''

italian =''' !"$'()+,-.:;<=>?[]_`abcdefghijklmnopqrstuvwxyz{}~¡«°´µº»ßàáâãäåæèéêëìíîïðñòóôöøùúûþÿāąćčđėęěğīıľłńňōőœřśşšūŭźżžșțəʻʼʾʿː̨́абдеиклмностуцшѐёљңדהוةرسصغليḥṇṛṣṭễ‑–—‘’“”„…′☆♭♯あアカキサザノフリン・ー万三丰古多家峰張旅禅ꞌ'''

arabic =''' !"',-.:;?egt«»،؛؟ءآأؤإئابةتثجحخدذرزسشصضطظعغـفقكلمنهوىيًٌٍَُِّْٰٓچکیۖۗۘۙۚۛ–“”…ﺃ'''

korean =''' 가각간갈감갑값갓갔강갖같갚개객갠갤갯갱거걱건걷걸검겁것겉게겐겟겠겨격겪견결겸겹겼경곁계고곡곤곧골곰곱곳공곶과곽관괄괌광괘괭괴굉교구국군굳굴굵굶굽굿궁궈권궐궤귀규균그극근글금급긋긍기긴길김깁깃깊까깎깔깝깡깥깨깬꺼껍껏껑께껴꼈꼬꼭꼴꼼꼽꽁꽂꽃꽝꽥꾸꾼꿀꿇꿈꿎꿔꿨꿰뀌뀐끄끅끈끊끌끓끔끗끝끼끽낀낌나낙난날낡남납낫났낭낮낯낳내낸낼냄냅냇냈냉냐냥너넉넌널넓넘넛넣네넥넨넷녀녁년념녔녕녘노녹논놀놈농높놓놨뇌뇨뇽누눈눌눠뉜뉴늉느는늘늠능늦늪늬니닉닌닐님닙닛닝다닥닦단닫달닭닮닳담답닷당닿대댁댐댓더덕던덜덟덤덧덩덫덮데덴델뎅뎌도독돈돋돌돔돕돗동돛돼됐되된될됨됩두둑둔둘둠둥둬뒀뒤뒷듀드득든듣들듬듭듯등디딘딜딥딨딩딪따딱딴딸땀땄땅때땐땠땡떠떡떤떨떴떻떼뗄또똑똥뚜뚝뚫뛰뛴뜨뜯뜸뜻띄띔띠띤띨띵라락란랄람랍랐랑래랙랜램랫랬랭랴략량러럭런럴럼럽렀렁렇레렉렌렘렛려력련렬렴렵렷렸령례로록론롤롬롭롯롱뢰료룡루룬룰룸룹뤄뤘뤼류륙륜률륭르륵른를름릅릇릉릎리릭린릴림립릿링마막만많맏말맑맘맙맛망맞맡매맥맨맹맺머먹먼멀멈멋멍메멕멘멜멧며면멸명몇모목몫몬몰몸못몽묘무묵묶문묻물뭄뭇뭐뭔뭘뮤뮬므믈미믹민믿밀밋밌밍및밑바박밖반받발밝밤밥방밭배백밴뱀뱃뱅버벅번벌범법벗벚베벤벨벳벼벽변별볍볐병볕보복볶본볼봄봅봇봉봐봤뵈뵙부북분불붉붐붓붕붙뷔뷰브븐블비빅빈빌빗빙빚빛빠빨빵빼뺀뺌뺏뺑뻐뻑뻔뻗뻘뼈뽀뽑뽕뿌뿐뿜쁘쁜쁩삐사삭산살삶삼삽삿샀상새색샌샐샘생샤샬샵샷서석섞선섣설섬섭섯섰성세섹센셀셈셉셋셔션셜셨셰소속손솔솜솟송솥쇄쇠쇤쇼숍수숙순술숨숭숲쉬쉰쉼쉽슈슐스슨슬슴습슷승시식신실싫심십싱싶싸싹싼쌀쌈쌌쌍쌓써썩썰썼쏘쏜쏟쏠쑤쓰쓴쓸씀씁씌씨씩씬씸씻아악안앉않알앓암압앗았앙앞애액앤앨앱앵야약얇양얗얘어억언얹얻얼얽엄업없엇었엉엎에엑엔엘엠엡엣여역연열엷염엽엿였영옆예옛오옥온올옮옳옴옵옷옹와완왈왔왕왜외왼요욕용우욱운울움웁웃웅워원월웠웨웬웹위윈윌윗윙유육윤율융으은을음읍응의이익인일읽잃임입잇있잉잊잎자작잔잖잘잠잡잣장잦재잭잰잽쟁저적전절젊젋점접젓정젖제젝젠젤져젼졌조족존졸좀좁종좋좌죄죠주죽준줄줍중줘줬쥐쥔쥘쥬즈즉즌즐즘증지직진질짊짐집짓징짖짙짚짜짝짧짬째쨌쩌쩍쩔쩜쪼쪽쫄쫓쭉쯤찌찍찔찢찧차착찬찮찰참찻창찾채책챌챔챙챠처척천철첨첩첫청체첸첼쳇쳐쳤초촉촌촘촛총촨촬최추축춘출춤충춰취츠측츰층치칙친칠침칩칫칭카칸칼캉캐캔캘캠커컥컨컫컴컵컷컸케켈켐켑켓켜켰코콘콜콤콥콧콩쾌쿄쿠쿡쿨쿼퀴큐크큰클큼키킥킨킬킷킹타탁탄탈탐탑탓탕태택탠탬탱터턱턴털텃텅테텍텐텔템텼토톡톤톨톰통퇴투툴툼퉁튀튜튬트특튼튿틀틈티틱틴틸팀팅파팍팎판팔팜팡패팩팬팰팻팽퍼펀펄펌페펜펠펫펴편펼폄폈평폐포폭폰폴폼표푸푹푼풀품풋풍퓨퓰프픈플픔피픽핀필핏핑하학한할함합핫항해핵핸햇했행향허헌헐험헝헤헨헬헴헷혀혁현혈혐협혔형혜호혹혼홀홈홉홍화확환활황회획횡효후훈훌훤훨훼휘휩휴흉흐흑흔흘흙흠흡흥흩희흰히힌힐힘'''

russian =''' !"'(),-.:;?abcefghiklmnoprstxz«»абвгдежзийклмнопрстуфхцчшщъыьэюяё‑–—“„…−'''

thai =''' กขคฆงจฉชซญณดตถทธนบปผฝพฟภมยรฤลวศษสหอฮะัาำิีึืุูเแโใไ็่้๊๋์'''

japanese =''' !',-.?abcdefghijklmnopqrstuvwxyzμ―‘’“”…☆♡⤴、。々〇〈〉「」『』〜ぁあぃいぅうぇえぉおかがきぎくぐけげこごさざしじすずせぜそぞただちっつづてでとどなにぬねのはばぱひびぴふぶぷへべぺほぼぽまみむめもゃやゅゆょよらりるれろゎわゐをん゛ゝゞァアィイゥウェエォオカガキギクグケゲコゴサザシジスズセゼソゾタダチッツテデトドナニヌネノハバパヒビピフブプヘベペホボポマミムメモャヤュユョヨラリルレロワンヴヵヶ・ー一丁七万丈三上下不与且世丘両並中串丸丹主丼乃久之乏乖乗乙九也乱乳乾亀了予争事二于云互五井亘亜亡交京亭人仁今介仏仕他付仙代令以仮仰仲件任企伊伍伏伐休会伝传伯伴伸似但佇位低住佐体何余作佳併使例侑供依価侮侵便係俄俗保俟信俣修俯俳俺倉個倍倒候借倣値倫倶偉偏做停健側偵偶偽傍傑傘備催債傷傾僅働像僕僚僧儀億儘儚償優允元兄充兆先光克免兎児党入全八公六共兵具典兼内円冊再冒冗写冠冬冴冷凄凌凍凛凝凡処凧凪凶出函刀刃分切刈刊刑列初判別利到制刷券刺刻則削前剛剣剤剥副割創劇力功加劣助努劫励労効勃勇勉動勘務勝募勢勤勧勿匂包化北匠匹区医匿十千午半卑卒卓協南単博占印危即却卵厄厚原厨厭厳去参及友双反収取受叙叛叡口古句叩只叫召可台叱史右叶号司各合吉吊同名后吐向君吟吠否含吸吹吾呂呆呈呉告呑呟周味呻呼命咋和咥咲咳咽哀品員哲唄唆唇唐唖唯唱唸唾商問善喉喋喚喜喧喩喪喫喬喰営嗅嘆嘉嘘嘩嘲噂噌噛器噴囚四回因団困囲図固国圏園土圧在地坂均坊坐坑坪垂型垢垣埃埋城域執培基埼堀堂堅堕堤堪報場堵堺塀塁塊塔塗塙塚塩塵塾境墓増墨壁壇壊壌士壬壮声壱売壷壺変夏夕外多夜夢大天太夫央失奄奇奈奉奏契奔套奥奨奪奮女奴好如妃妄妖妙妥妨妬妹妻姉始姓委姦姫姶姻姿威娘娯婆婚婦婿媒媛媽嫁嫉嫌嬉嬢嬬子孔孕字存孝季孤学孫宅宇守安完宍宗官宙定宛宜宝実客宣室宮宰害宴宵家容宿寂寄密富寒寛寝察寧審寵寸寺対寿封専射将尊尋導小少尖尚尤就尺尻尼尽尾尿局居屈届屋屏屑展属層履屯山岐岡岩岬岸峙峠峡峰島崇崎崔崖崩嵐嵩嶋川州巡巣工左巧巨差己巻巾市布帆希帖帝師席帯帰帳常帽幅幌幕幡干平年并幸幹幻幼幽幾庁広庄床序底庖店府度座庫庭庵康廃廉廊廓延廷建廻廿弁弄弊式弐弓引弘弟弥弦弱張強弾当彙形彦彩彫彰影役彼往征待律後徐徒従得御復循微徳徴徹徽心必忍志忘忙応忠快念怒怖思怠急性怨怪怯恋恐恥恨恩息恰恵悔悟悠患悦悩悪悲悶情惑惚惜惟惨惰想惹愉意愕愚愛感慄慈態慌慎慕慢慣慨慮慰慶憂憎憐憑憚憤憧憩憲憶應懊懐懸成我戒或戚戦戯戸戻房所扇扉手才打払扱扶批承技抄把抑投抗折抜択披抱抵抹押抽担拉拍拒拓拗拘招拝拠拡括拭拳拶拾持指挑挙挟挨挫振挾挿捉捌捕捜捧捨捲捻掃授掌排掘掛掟掠採探接控推措掬掲掴掻揃揄描提揖揚換握揮援揶揺損搬搭携搾摂摘摩撃撒撚撞撤撫播撮擁操擢擦支改攻放政故敏救敗教敢散敦敬数整敵敷文斉斎斐斑斗料斜斧斬断斯新方於施旅族旗既日旦旧旨早旬旭旺昂昆昇昌明易昔星映春昧昨昭是昼時晒晦晩普景晴晶智暇暑暖暗暦暫暮暴曇曖曜曲曳更書曹曽替最月有朋服朕朗望朝期朦朧木未末本札朴机权杉李材村杓杖杜束条来杭杯東杵松板析枕林枚果枝枢枯架柄柏染柔柢柱柳柴柵査柿栃栄栖栗校株核根格栽桁桂桃案桎桐桑桔桜桶梁梅梏梗條梧梨梯械梱梼棄棋棒棚棟森棲椅植椎検楊楢業極楽概榛構槌様槻槽標模権横樹樽橄橋橙機橿檎檜櫃櫻欄欅欒欖欠次欧欲欺歌歎歓止正此武歩歪歯歳歴死歿殊残殖殴段殺殻殿母毎毒比毛毫毯氏民気水氷永汁求汗汚汝江池汲決汽沈沖沙没沢沫河沸油治沼沿況泉泊法泡波泣泥注泪泰泳洋洒洗洞津洪洲活派流浄浅浙浜浦浩浪浮浴海浸消涌涎涙涯液涼淀淡深淵混淹添清渇済渉渋渓減渡渦温測港渾湖湧湯湾湿満源準溜溝溢溶溺滅滋滑滝滞滲滴漁漂漆漏演漕漠漢漫漬潔潜潟潤潮潰澄澤激濁濃濡濫濯瀋瀞瀟瀬灘火灯灰災炉炊炎炒炬炭炸点為烈烏烹焔無焦然焼煉煎煙照煮熊熟熱熾燃燈燕燥燵爆爪爵父爺爽爾片版牙牛牝牟牡牢牧物牲特牽犠犧犬犯状狂狐狙狛狩独狭猛猟猪猫献猶猿獄獅獣獰獲玄率玉王玖珀珂珍珠班現球理琢琥琴瑕瑛瑞璃璧環瓢瓦瓶甘生産甥用田由甲申男町画界畏畑留畜畠畢略番異畳畷疆疑疫疲疵疾病症痛痩痰痴痺瘠療癒癖癪発登發白百的皆皇皮皺皿盆益盗盛盟監盤目盲直相盾省眉看県真眠眸眺眼着睡督睦瞑瞬瞭瞳矛矢知矩短矮矯石砂研砕砥砦砲破砺硝硬确碁碑碗碧確磁磐磨磯礎礫示礼社祈祉祓祖祝神祠祢祥票祭禁禄禍福禽秀私秋科秒秘秦秩称移程税稚種稲稼稽稿穀穂積穏穴究空突窃窓窟窪竈立竜竟章童端競竹笑笛笠符第笹筆筈等筋筑筒答策箆箇箋箔箕算管箱箸節範築篠簔簡簾簿籍籐籠米粉粋粒粕粗粘粛粟粧精糖糞糠糧糸系紀約紅紋納紐純紗紙級紛素索紫細紳紹終組絆経結絞絡給絨統絵絶絹継続綜維綱網綺綻綾綿緊総緑緒線締編緩練縁縄縛縞縦縫縮績繁繊繋織繕繞繫繰繹纂纏缶罠罪置罰署罵羅羊美群義羽翁翅翌習翔翻翼老考者耆而耐耕耳聖聞聴職肆肉肌肘肝股肢肥肩肪肯育肺胃胆背胎胞胡胸能脂脅脆脇脈脊脚脱脳脹腎腐腑腕腰腱腹腿膚膜膝膨膳膵臆臍臓臣臨自臭至致臼興舌舎舐舗舘舞舟航般船艘艦良色艶芋芝芥芦芯花芳芸芽苅苑苓苔苗苛若苦苫英苺茂茅茎茨茶茹草荒荘荷菅菊菓菜華菰菱萌萎萩落葉著葛葦葬葵蒙蒡蒲蒸蓄蓋蓬蓮蔑蔓蔭蔵蕎蕨薄薇薔薩薬藁藍藝藤藻蘂蘆蘇蘭虎虚虫虹虻蚊蛇蛍蛙蛮蛹蛾蝉蝶融蟲蟹蟻蠣血衆行術街衛衝衡衣表衰衾袋袖被袴裁裂装裏裕補裳裸製裾複褐褪襟襲西要覆覇見規視覗覚覧親観角解触言訂計訊討訓託記訟訣訪設許訳訴診証詐詑評詞詠詣試詩詮詰話詳誇誉誌認誑誓誕誘語誠誤誦説読誰課調談請諏論諦諫諸謀謂謎謙講謝謡謬謹識譜警議譲護讐认话读谷豆豊豚象豪貌貝貞負財貢貧貨販貪貫責貯貰貴買貸費貼貿賀賂賃賄資賊賑賛賞賠賢賦質賭購賽贅贈赤赦走起超越趣足距跡跨路跳践踊踏蹟蹴躇躊躍身車軋軌軍軒軟転軸軽較載輝輩輪輸輾轄辛辞辰辱農辺込辿迅迎近返这迦迫述迷追退送逃逅逆透逐途逗這通逝速造逢連逮週進逸遂遅遇遊運遍過道達違遠遣遥適遭遮遷選遺遼遽避邂還邑那邦邪邸郊郎郡部郵郷都鄙鄭配酒酔酢酬酵酷酸醍醐醒醜醤釈里重野量金釘釜針釣釧鈍鈴鉄鉛鉢鉱鉾銀銃銅銚銭鋤鋭錆錠錦録鍋鍛鍵鎌鎖鏡鐘鑑長門閃閉開閑間関閣閨閲闇闘阅阜阪防阻阿陀附降限陛陝院陣除陥陰陳陵陸険陽隅隆隊隋階随隔隙際障隠隣隷隻雀雄雅集雇雑離難雨雪雫雰雲雷電需震霊霞霧露霹靂青静非面革靴鞍鞘鞠鞭韋韓韮音韻響頂頃項順須預頑頓頗領頬頭頷頸頻頼題額顎顔顕願類顧领風飛飜食飢飯飲飴飼飽飾餃餅養餌餓館饅首香馬馭馳馴駄駅駆駈駐駒駝駿騎騒験騨騰驚骨骸高髪髭鬱鬼魂魅魔魚鮫鮭鮮鯖鯛鰐鰡鰭鰺鰻鳥鳩鳴鴉鴎鴨鴻鶏鶴鷲鷹鸞鹸鹿麗麦麺麻黄黒黙鼓鼠鼻鼾齢齧龍녕러분세안여요하︎！（），．／；＝？＼＾ａｂｃｄｆｇｈｉｊｋｌｍｎｏｐｒｓｔｕｖｗｙｚ～｢｣ｩ'''

